1, 2, 2, 2, 2, 2, 2, 3, 0, 0, 0, 0, 0,
5, 6, 6, 6, 6, 6, 6, 7, 0, 0, 0, 0, 0,
5, 6, 6, 6, 6, 6, 6, 7, 0, 0, 0, 0, 0,
5, 6, 6, 6, 6, 6, 6, 17,2, 2, 2, 2, 3,
5, 6, 6, 6, 6, 6, 6, 6, 6, 6, 6, 6, 7,
5, 6, 6, 6, 6, 6, 6, 6, 6, 6, 6, 6, 7,
5, 6, 6, 6, 6, 6, 6, 6, 6, 6, 6, 6, 7,
5, 6, 6, 6, 6, 6, 6, 4,11,11,11,11,12,
5, 6, 6, 6, 6, 6, 6, 7, 0, 0, 0, 0, 0,
10,11,11,11,11,11,11,12,0, 0, 0, 0, 0
