0,1,1,1,1,1,1,2,
4,5,5,5,5,5,5,13,
4,5,5,-1,-1,5,6,13,
4,4,5,-1,-1,1,6,13,
4,13,13,13,13,13,12,13,
4,5,5,5,5,5,6,13,
4,5,5,5,5,5,6,13,
9,10,10,10,10,10,10,11
